*************
*    0	0   *
* * * * * * *
*           *
* * * * * * *
*           *
* * * * * * *
*           *
* * * * * * *
*           *
* * * * * * *
*           *
*************