***************
*1x         xx*
*x# # # # # #x*
*             *
* # # # # # # *
*             *
* # # # # # # *
*             *
* # # # # # # *
*             *
* # # # # # # *
*             *
*x# # # # # #x*
*xx         x2*
***************